wwwwwwwww
w...n...w
w.......w
w.......w
w.......w
w.......w
w.......w
w.......w
w.......w
w...s...w
w.......w
w.......w
w.......w
w.......w
w.......w
w.......w
w.......w
w.......w
w.......w
w.......w
w.......w
w.......w
w.......w
w.......w
w.......w
w.......w
w.......w
w.......w
w.......w
w.......w
w.......w
w.......w
w.......w
w.......w
w.......w
w.......w
w.......w
w.......w
w.......w
w.......w
w.......w
w.......w
w.......w
w.......w
w.......w
w.......w
w.......w
w.......w
w.......w
w.......w
w.......w
w.......w
w.......w
w.......w
w.......w
w.......w
w.......w
w.......w
w.......w
w.......w
w.......w
w.......w
w.......w
w.......w
w.......w
w.......w
w.......w
w.......w
w.......w
w.......w
w.......w
w.......w
w.......w
w.......w
w.......w
w.......w
wwwwwwwww